Journalist und Autor: Peter Scholl-Latour ist tot
Neue Gadgets: So machen Sie Ihr Fahrrad zum E-Bike
Multimedia-Tagebuch der Krim-Reise: In der Atomruine von Schtscholkine
Blamierte Bundesligisten: Die 18 größten Sensationen im DFB-Pokal
Freie Fahrt auf Busspuren: Großstädte lehnen Privilegien für Elektroautos ab
Fußball-EM und Olympia: DFL-Chef Seifert für Doppelbewerbung 2024
Blinde Passagiere: 31 Menschen in Container in britischem Hafen gefunden
"Promi Big Brother": Effenberg und Co. holen gute Quoten
Kosten für Polizei-Einsätze: Rauball droht Bremen mit Bundesverfassungsgericht
Reaktionen auf BND-Abhöraffäre: "Merkel muss sich umgehend erklären"
Nach Tod einer Elfjährigen: Holiday Park sagt Show ab
Tyrion, Arya, Khaleesi: Briten benennen Babys nach Helden aus "Game of Thrones"
"Ice Bucket Challenge": Bill Gates macht\'s eiskalt
Chemnitz-Torwart Philipp Pentke: Vom Deppen zum Helden in 15 Minuten
"Islamischer Staat" in Deutschland: Der schwierige Kampf gegen die Terroranhänger
Heute in den Feuilletons: In einer künftigen Stadt sind wir alle Immigranten
Pressekompass: Dating-App "Tinder" - Liebe, Sex und Lustgewinn?
Amerikas Schwarze zum Tod von Michael Brown: "Sie sehen dich immer als Feind"
Geheimdienste: BND überwacht seit Jahren Nato-Partner Türkei
Hunderttausende bei Freiluftmesse: Papst spricht 124 koreanische Märtyrer selig
Ethnien: Weiße Schüler an US-Schulen erstmals in der Minderheit
Party-Rezepte: Häppchen fürs Händchen
Auf und Ab der Aktienkurse: Neue Regeln an der Börse
La Graciosa bei Lanzarote: Eine Insel, drei Vulkane und ganz viel Sand
Experimentelle Krebstherapie: Bakterien lassen Tumoren schrumpfen
Kampf gegen "Islamischer Staat": Bundeswehr landet mit ersten Hilfsgütern im Nordirak
Österreichische Alpen: Retter befreien verletzten Forscher aus Jack-Daniel\'s-Höhle
SMS Audio BioSport: Diese Kopfhörer schauen aufs Herz
Fünftligist Paloma im DFB-Pokal: Die weißen Tauben sind flügge
"Promi Big Brother" bei Sat.1: Tittenprinz und Busenmadämchen
Mögliche Grenzverletzungen: USA werfen Putin Militärintervention in der Ukraine vor
Nissan e-NV200: Der Leaferwagen
Satellitenbild der Woche: Pazifische Sturmparade
Feuer in Berliner Moschee: Neue Spuren deuten nun doch auf Brandanschlag hin
Irak und Syrien: Uno-Sicherheitsrat verabschiedet Resolution gegen Dschihadisten
Champions League: Legia Warschau zieht vor den Sportgerichtshof
Leichenschändung in Afghanistan: Ex-Soldat aus Skandalvideo mit 28 Jahren gestorben
DFB-Pokal: Mainz scheitert dramatisch - auch Nürnberg raus
Zurückgelassenes \xc4ffchen "Mally": Justin Bieber beendet Affentheater
Leichtathletik-EM: DSV-Athleten verpassen weitere Medaillen
Krieg in der Ostukraine: "Mit dem Panzer fahren wir zum Angeln"
Party-Logbuch Mainz: Wo der Weinstubenwirt mit Kloppo angibt
Streit in Frankreich: Eine Ortschaft namens "Tod-den-Juden"
Todesschuss in Ferguson: Polizeichef veröffentlicht neue Details zum Tathergang
Spionageaffäre: BND hörte US-Außenministerin Clinton ab
Arsenal-Verteidiger: Mertesacker tritt aus Nationalelf zurück
Krisengespräch: Außenminister der Ukraine und Russlands treffen sich in Berlin
Videodays: Schlange stehen für die YouTube-Stars
Moderne Flughäfen: Im totalitären Luxus-Zoo
Performance in Hamburg: Die Freaks im Glaskasten
Todesangst: Hexengewehre und andere Ebola-Gerüchte
Konflikt um Grenzverletzung: Ukraine meldet Angriff auf russischen Militärkonvoi
Roboter-Flashmob: Tanzende Schwarmintelligenz
Attacke auf russischen Konvoi: Börsen rutschen schlagartig ins Minus
Toter und Verletzte in Schleswig-Holstein: Gas-Auto explodiert nach Unfall
Neuer Besitzer Ren\xe9 Benko: Karstadts letzte Chance
"Downton Abbey": PR mit Plastikflasche
Toter Michael Brown: Fergusons Polizeichef nennt Namen des Schützen
Förderung von E-Autos: Völlig neben der Spur
Fernwartung: Sicherheitslücke entblößt Millionen DSL-Router
Reformpläne der Regierung: Gegner eines Sterbehilfe-Verbots formieren sich
Familie und Beruf: "Warum ich den besten Job hinschmeiße, den ich je hatte"
Irak-Krise: EU für Waffenlieferungen an Kurden
Borussia Dortmund: Schmelzer fehlt verletzt, Reus vor Rückkehr
Karstadt-Verkauf: Berggruen räumt Fehler ein - aber nicht den größten
Privater Raumfrachter "Cygnus": Die letzte Reise
Disqualifizierte Sportler: Dumm gelaufen
GKV: Alte Versichertenkarten verlieren 2015 ihre Gültigkeit
Saisonstart in England: Die Buyern von der Insel
Zweite spanische Liga: Streit um Zwangsabstieg Murcias verhindert Saisonstart
Chaos bei 1860: Löwen-Trainer begnadigt degradierte Spieler
Warnung von \xc4rzte ohne Grenzen: Ebola-Epidemie noch für Monate außer Kontrolle
Stalking-Roman von Judith Hermann: Das halbnackte Grauen
Berichte über Grenzverletzung: Nato wirft Russland Eskalation im Ukraine-Konflikt vor
Holiday Park in Rheinland-Pfalz: Elfjährige verletzt sich an Fahrgeschäft und stirbt
Rückkehr der Raubtiere: Mindestens hundert Wölfe leben in Deutschland
FC Barcelona: Nationalspieler ter Stegen fällt drei Wochen aus
Terror in Nigeria: Boko Haram entführt Dutzende Jungen und Männer
Chrysler-\xdcbernahme: Wirtschaftskrise bringt Marchionnes Plan durcheinander
Codename Hacienda: NSA und Partnerdienste scannen ganze Länder auf IT-Schwachstellen
Listerien-Verdacht: Verseuchte Wurst auch auf Ostseefähren verkauft
Zugunglück in Mannheim: Schaden für die Deutsche Bahn ist mindestens sechsstellig
Jesidische Flüchtlinge im Irak: "Wir haben unsere Heimat für immer verloren"
Polizeichef Ron Johnson: Der Friedensstifter von Ferguson
Erschossener Liechtensteiner Bankchef: Leiche des Tatverdächtigen im Bodensee gefunden
Flüchtlinge in Deutschland: Zahl der Asylbewerber steigt auf Höchstwert seit 1993
Hilfsflüge der Bundeswehr: Außenminister Steinmeier reist in den Irak
WM-Report: Netto-Spielzeit zwischen 47 und 70 Minuten
Kanal wird zu Surf-Spot: Rotterdam macht \'ne Riesenwelle
Motorvibration: Mercedes ordert Smart in die Werkstätten
Bundestrojaner: BKA stellt ersten eigenen Trojaner fertig
Multimedia-Tagebuch zur Krim-Reise: Die alten Krieger
Leichtathletik-EM: Geher Diniz stellt Weltrekord über 50 Kilometer auf
Malaysia Airlines: Steward wegen sexueller Belästigung festgenommen
Schweiz: 60-Jähriger soll Frauen im Keller gequält und gefilmt haben
Protest gegen Gaza-Krieg: Niederländer gibt israelische Auszeichnung zurück
Effektive Ganzkörperübung Burpee: Liegestütze mit Flugphase
Mathematik: 29 Zahlen lösen jahrhundertealtes Problem
+++ Fußball-Transferticker +++: Bremen verkauft Ekici an Trabzonspor
Mölzer-Abend der AfD in Leipzig: Sachsen-Wahlkampf am braunen Rand
Analyse von Facebook und Co.: Suchmaschine erstellt Ranking von Hotelgästen
Skandal-Stürmer: Su\xe1rez\' erstes Training bei Barcelona
Fachkräfte aus der EU: Weise räumt Pannen bei der Integration ein
Nicky Hilton: Erbin heiratet Erben
Pärchen auf der Gamescom in Köln: "Ich werde aggressiv, weil er mich ständig tötet"
Gravitationsbiologie: Wenn Sonnenblumen durchdrehen
Uno-Treffen in New York: Merkel lässt sich beim Klima-Sondergipfel von Hendricks vertreten
\xdcberwachung: Forscher wollen Lauschangriff auf Handys über Bewegungssensoren zeigen
Fotostrecke: Rettungsaktion im Tennengebirge
Grenzkonflikt: Russland bestreitet Eindringen von Soldaten in die Ukraine
Angetippt: Diese Schreibmaschinen-App hat den Segen von Tom Hanks
Außenseiter Waldalgesheim im DFB-Pokal: Hauptsache, das Bistro wird schöner
Bei Pep Guardiola auf der Bank: "Ich traute mich kaum zu atmen"
Grenze Ukraine-Russland: Nervenkrieg um Putins Konvoi
Thailand: Paare mit Babys von Leihmüttern an Ausreise gehindert
Tödlicher Rennunfall: Nascar-Star Stewart sagt weiteren Start ab
Imran Khan: Pakistans Oppositionsführer überlebt Anschlag unverletzt
Verunglückter Forscher in Alpen: Retter beginnen mit Bergung aus Jack-Daniel\'s-Höhle
Ungarischer Premier: Orb\xe1n ätzt gegen Brüssels Russland-Sanktionen
Heute in den Feuilletons: "Riesenschlange aus albernsten Fettnäpfchen"
Ausländische Bundesliga-Torjäger: Der Beste trifft noch immer
Burgenblogger gesucht: Tausche Büro gegen Schlosszimmer
Altes Land bei Hamburg: Ein Herz für \xc4pfel
Traditionelle Jagd in Indonesien: Im Dorf der Walfänger
Stromproduktion: Belgien schaltet dritten Atomreaktor ab
Polit-Thriller "Night Moves": Ja sagen zur Bombe
Tier macht Sachen: Mutter und Tochter verschanzen sich vor wütendem Kater
Pakistan: Aufständische attackieren Stützpunkte der Luftwaffe
Neue Sammelbox: Die Singer-Songwriter-Hörbibel
Bitcoin: Ebay-Tochter verhandelt über Einführung von virtueller Währung
Franziskus in Südkorea: Zehntausende jubeln dem Papst zu
Machtkampf der Obst-Riesen: Chiquita wehrt sich gegen \xdcbernahme
Goldjubel "Oben ohne": Halbnackter Hindernisläufer verliert EM-Titel
Kurz-Auftritt bei Party: Nicki Minajs 53.000-Dollar-Abstecher
Unterstützung für Kurden: Erster Hilfsflug der Bundeswehr gestartet
Ungewöhnliche Studentenwohnungen: Wer hilft, wohnt billiger
Recycling: Entsorger kommen Lösung für gelbe Tonne näher
Portugal: Gericht kippt erneut Spargesetz der Regierung
Proteste in Missouri: Gouverneur entmachtet die verhasste Polizei von Ferguson
Fotostrecke: Tarnfleck in Ferguson
Rebellion gegen Amazon: Die Autoren schreien - und wir sollten zuhören
Schutz von Zivilisten: USA fordern Zurückhaltung von ukrainischer Armee
Weltgesundheitsorganisation: Ebola-Ausbruch in Westafrika noch schlimmer als gedacht
Rekordpreis: Dieser Ferrari ist das teuerste Auktions-Auto der Welt
Newsblog: Das war DerMorgen @SPIEGELONLINE
Britische Medienberichte: Russische Truppentransporter sollen in die Ukraine vorgerückt sein
Machtkampf in Bagdad: Iraks Regierungschef Maliki tritt ab
Leichtathletik-EM: Speerwerferin Stahl holt Bronze
Unterstützung im Kampf gegen IS: Von der Leyen spricht von "deutschen Waffen" für Irak
Leichtathletik-EM: Hindernislauf-Sieger zieht schon vor dem Ziel das Trikot aus 
Tod des Schauspielers: Robin Williams litt laut seiner Witwe an Parkinson
Erschossener Mike Brown: Unbekannte veröffentlichen falschen Namen des Schützen von Ferguson
Unterstützung im Kampf gegen IS: Bundeswehr startet Hilfsflüge für Nordirak
Suche nach Sternenstaub: Sieben Körnchen auf einen Streich
Spielemesse Gamescom: Hardcore!
Berkshire Hathaway: Buffett-Aktie steigt erstmals über 200.000 Dollar
Prostitutionsgesetz: Koalition will Gang-Bang-Partys verbieten
Hilfsgüter: Russischer Konvoi campiert nahe ukrainischer Grenze
Ferrari 250 GTO: Der 50-Millionen-Dollar-Unfallwagen
Vorwurf des Kindesmissbrauchs: Polizei durchsucht Cliff Richards Wohnung
Neuer Warenhausbesitzer: Benko wirft Berggruen bei Karstadt raus
Tagesvorschau: Was Freitag wichtig wird
+++ Fußball-Transferticker +++: Conte ist neuer Nationaltrainer Italiens
Desinfektionsmittel: Chemikalien machen Mäuse unfruchtbar
Schwache Konjunktur: Die Lohn-Illusion
Nullwachstum: So gefährdet ist Europas Wirtschaft
Prorussische Kämpfer: Militärchef Strelkow tritt zurück
Urteil im Fall Gustl Mollath: Freispruch dritter Klasse
Baden-Württemberg: Bundeswehr darf an Schulen nicht für den Wehrdienst werben
Urteil: BGH verbietet Werbung mit Selbstverständlichkeiten
Internationales Teletext Art Festival: Oh Videotext, wie violett und virtuos bist du
Österreichische Alpen: Höhlenforscher verunglückt in Jack-Daniel\'s-Höhle
Balearen-Insel Ibiza: Hier sonnt sich Kate Moss neben Leonardo DiCaprio
Augenblick: Drachenwelle
Krise im Irak: Deutscher Islamist bei Kämpfen in Mossul getötet
Autobahnschütze: Anwälte kritisieren massenhafte Erfassung von Nummernschildern
Keine US-Luftbrücke: Wie es für die Flüchtlinge im Irak weitergeht
Langjähriger Bundesligaprofi: Van Buyten beendet Karriere
Georg Funke: Ex-Chef der Hypo Real Estate droht Anklage
"Yolo", "side boob", "bro hug": Englisches Wörterbuch nimmt Szenewörter auf
Solidarität mit Protest in Ferguson: Erschießt uns nicht
Zeitverschwendung im Job: E-Mails kosten einen Arbeitstag pro Woche
Kreuzbandriss bei Mart\xednez: Guardiolas große Lücke
Kevlar-Mantel: Google sichert Tiefseekabel gegen Haiangriffe
Expedition in Burma: Taucher suchen nach mysteriöser Riesenglocke
"Dick wie eine Kuh"-Kampagne: Der Milch-Quark der Veganer
Anti-Milch-Kampagnen: Milch ist besser als ihr Ruf
Listerien-Verdacht: 160 Kilo Wurst von dänischem Hersteller in Deutschland verkauft
Handel mit CO2-Zertifikaten: Tesla poliert Dreckschleudern auf
Champions League: Uefa lehnt Einspruch von Legia Warschau ab
Europas Fußballer des Jahres: Neuer unter den drei Finalisten
WM-Bissattacke: Sportgerichtshof bestätigt Su\xe1rez-Sperre
Ostukraine: Ukrainische Armee feuert auf Zentrum von Donezk
Jahresbilanz 2013: Jugendämter sehen 38.000 Kinder als gefährdet an
Online-Bestell-Plattform: Essensportal Delivery Hero schluckt Konkurrenten
Verlag Gruner + Jahr: "Gala"-Chef wird "Stern"-Chef
Ostsee: Deutsche Handelsschifffahrt leidet unter Ukraine-Krise
Krieg in Gaza, der Ukraine und im Irak: Waffen! Waffen! Waffen!
 Vorbereitungskurs zum "Idiotentest" : Führerschein fürs Leben
Freiwasserschwimmer bei der EM: Härle holt Gold, Lurz gewinnt Silber
Trauer in Johannesburg: Afrikas letzter Eisbär ist tot
Streit um Herz-OP: Gießener Klinik will türkisches Kind wegen Anfeindungen verlegen
Pressekompass: Mollath-Urteil - Schuld und Freiheit
Bilanz 2013/2014: BVB macht deutlich weniger Umsatz und Gewinn
Schwedens Superstar: Ibrahimovic will spätestens 2016 aufhören
Mollath über Urteil: "Das kann man so nicht hinnehmen"
Fledermäuse im Windpark: Tod auf der Durchreise
PTBS nach Flugzeugabsturz: Traumatisierte erinnern sich anders
Linke Kinolegende Ken Loach: "Man muss sich ins Gefecht begeben"
Uno-Schätzung: Rund 1000 Jesiden harren noch im Gebirge aus
Ferguson nach Michael Browns Tod: Eine Kleinstadt wird zur Kampfzone
Fotostrecke: Gespenstische Szenen in Ferguson
Pemex: Mexikos staatlicher Ölkonzern behält Großteil der Reserven
Bodypainting an Akrobaten: Hui, Spinne
Taxi-App: Berlin verbietet Uber
Dominik Wichmann: "Stern"-Chef soll vor der Ablösung stehen
Platzverweise in der Bundesliga: Die Rot-Seher
Nahost: USA stoppen offenbar Lieferung von "Hellfire"-Raketen an Israel
Starmusiker: Dirigent und Blockflötist Frans Brüggen ist tot
Russischer Premier: Hacker knacken Medwedews Twitter-Account
Freiwasser-Drama: DSV-Chefin fordert neue Rettungs-Regeln
Stromerzeugung per Tattoo: Schwitzen für das Smartphone
Apokalypse in TV-Serien: Angriff der Zompire
Krise im Stromgeschäft: RWE will 9000 Megawatt vom Markt nehmen
Leichtathletik-EM: Organisatoren entschuldigen sich für Mess-Chaos
Leichtathletik-EM: Weitspringerin Bauschke verpasst Bronze und weint
Multimedia-Tagebuch: Reise auf die Krim
Gehaltsvergleich: Was bringt mein Studium?
Sanktionen gegen Russland: "Putin treibt einen Keil zwischen die westlichen Länder"
Reptilien mit Knochenkamm: Forscher entdecken neue Flugsaurierart
Passagierflugzeug: Armprothese von Pilot löst sich kurz vor Landung
Ottolenghis Rezept: Weihnachten im Sommer
Hilfe für Ostukraine: Russischer Konvoi nimmt Kurs auf Separatistengebiet
Eurostat: Inflation in Euroländern sinkt auf Rekordtief
Netzwerkprobleme: Speichermangel bremst das Internet aus
Chaos bei 1860: Löwen-Trainer setzt 18-jährigen Weigl als Kapitän ab
Heute in den Feuilletons: Aus dem Fernseher wölbt sich ein Gesäß
Machtkampf um Media-Saturn: Etappensieg für Metro gegen Kellerhals
Hunderte Patienten betroffen: Klinik in Australien verschickt falsche Todesmitteilungen
Italienische Nationalmannschaft: Conte soll Prandellis Nachfolge antreten
Staatspleite: Banken scheitern mit Hilfsangebot für Argentinien
Preiskampf auf dem Buchmarkt: Deutschsprachige Autoren greifen Amazon an
Familienalbum aus Amerika: Die Mischpoke und ich
Aubameyangs Masken-Jubel: Der spinnt doch!
Chronologie: Der Fall Gustl Mollath
Mercedes Actros SLT: Daimlers Dickster
Pokaltriumph für San Lorenzo: Papst-Klub gewinnt südamerikanische Champions League
Prozess in Regensburg: Freispruch für Gustl Mollath
Action-Film "Lucy": Scarlett allmächtig
Mumien: \xc4gypter balsamierten Tote bereits vor 5200 Jahren
Sorge um krebskranken Ehemann: C\xe9line Dion sagt geplante Tournee ab
Bayerns Supercup-Niederlage: Viele Probleme, viel Arbeit
Aus Ruanda zum Studium in die USA: Ein blutiger Weg
US-Erkundungsmission im Nordirak: Tausenden Jesiden gelingt die Flucht
Wegen Rückenverletzung: Woods verzichtet auf den Ryder Cup
Tourismusentwicklung auf Lombok: "Kuta muss seine Seele behalten"
Franziskus in Seoul: Nordkorea irritiert mit Raketentest vor Papstbesuch
Bruttoinlandsprodukt: Deutsche Wirtschaft überraschend geschrumpft
iPhone-Produktion: Apple verbietet Verwendung giftiger Chemikalien
Protestmarsch in Ferguson: Entrüstung über Festnahme von Reportern
Ren\xe9 Benko: Österreichischer Millionär will offenbar Karstadt kaufen
Manipulierte Kriegsfotos: Bilder, die lügen
Newsblog: Das war DerMorgen @SPIEGELONLINE
Testflug auf Hawaii: Bremsmanöver mit fliegender Untertasse
Kommentar zu Putins Machtpolitik: Krim gewonnen, Ukraine verloren
Grundgesetzänderung: Schwesigs Kinderrechtspläne gehen Union zu weit
Krise im Nordirak: Kurden flehen Deutschland um Hilfe an
